####################################################################################################
#..................................................................................................#
#..................................................................................................#
#....#####..#####..................................................................................#
#....#..........#..................................................................................#
#....#..........#..................................................................................#
#....#..........#..................................................................................#
#....#..........#..................................................................................#
#....#..........#..................................................................................#
#....#..........#..................................................................................#
#....#..........#..................................................................................#
#...............#..................................................................................#
#....#..........#..................................................................................#
#....#..........#..................................................................................#
#....#..........#..................................................................................#
#....#..........#..................................................................................#
#....############..................................................................................#
#..................................................................................................#
#..................................................................................................#
#..................................................................................................#
#..................................................................................................#
#..................................................................................................#
#..................................................................................................#
#..................................................................................................#
#..................................................................................................#
#..................................................................................................#
#..................................................................................................#
#..................................................................................................#
#..................................................................................................#
#..................................................................................................#
#..................................................................................................#
#..................................................................................................#
#..................................................................................................#
#..................................................................................................#
#..................................................................................................#
#..................................................................................................#
#..................................................................................................#
#..................................................................................................#
#..................................................................................................#
#..................................................................................................#
#..................................................................................................#
#..................................................................................................#
#..................................................................................................#
#..................................................................................................#
#..................................................................................................#
#..................................................................................................#
#..................................................................................................#
#..................................................................................................#
#..................................................................................................#
####################################################################################################