####################################################################################################
#..................................................................................................#
#..................................................................................................#
#..................................................................................................#
#..................................................................................................#
#..................................................................................................#
#..................................................................................................#
#..................................................................................................#
#..................................................................................................#
#..................................................................................................#
#..................................................................................................#
#..................................................................................................#
#..................................................................................................#
#..................................................................................................#
#..................................................................................................#
#..................................................................................................#
#..................................................................................................#
#..................................................................................................#
#..................................................................................................#
#..................................................................................................#
#..................................................................................................#
#..................................................................................................#
#..................................................................................................#
#..................................................................................................#
#..................................................................................................#
#..................................................................................................#
#..................................................................................................#
#..................................................................................................#
#..................................................................................................#
#..................................................................................................#
#..................................................................................................#
#..................................................................................................#
#..................................................................................................#
#..................................................................................................#
#..................................................................................................#
#..................................................................................................#
#..................................................................................................#
#..................................................................................................#
#..................................................................................................#
#..................................................................................................#
#..................................................................................................#
#..................................................................................................#
#..................................................................................................#
#..................................................................................................#
#..................................................................................................#
#..................................................................................................#
#..................................................................................................#
#..................................................................................................#
#..................................................................................................#
####################################################################################################