####################################################################################################
#..................................................................................................#
#..................................................................................................#
#....#####..#####..................................................................................#
#....#..........#..................................................................................#
#....#..........#..................................................................................#
#...............#..................................................................................#
#....#..........#..................................................................................#
#....#..........#..................................................................................#
#....#.............................................................................................#
#....#.............................................................................................#
#....#..........#..................................................................................#
#....#..........#..................................................................................#
#...............#..................................................................................#
#....#..........#..................................................................................#
#....#..........#..................................................................................#
#....#####..#####.........................................#######.#####............................#
#.........................................................#...........#............................#
#.........................................................#...........#............................#
#.........................................................#...........#............................#
#.........................................................#...........#............................#
#.........................................................#...........#............................#
#.........................................................##.####.#####............................#
#..................................................................................................#
#..................................................................................................#
#..................................................................................................#
#..................................................................................................#
#..................................................................................................#
#..................................................................................................#
#.................############..####...............................................................#
#.................#................#...............................................................#
#.................#................#...............................................................#
#.................#................#...............................................................#
#.................#................#...............................................................#
#.................#................#...............................................................#
#..................................#...............................................................#
#.................#................#...............................................................#
#.................######.###########...............................................................#
#..................................................................................................#
#..................................................................................................#
#..................................................................................................#
#..................................................................................................#
#..................................................................................................#
#..................................................................................................#
#..................................................................................................#
#..................................................................................................#
#..................................................................................................#
#..................................................................................................#
#..................................................................................................#
####################################################################################################